								  NO textures/north.xpm

						SO 						textures/south.xpm


	WE  	 	textures/west.xpm


EA textures/east.xpm

      F   									2,155,2
   		C         	    		12,1,123   				     
			
1111111111111111111111111
1000000000110000000100001
101100000111000N000100001
1001000000000001000100001
1111111110110000011111111
1000000000110000011101111
1111011111111101110000011
1111011111111100110101001
1100000011010101110000001
1000000000000000110000001
1000000000000000110101001
1100000111010101111101111
1111001111101011011110101
1111111111111111111111111