


NO                           textures/north_wall.xpm
                SO                                                 textures/mossy.xpm
WE                                                textures/greystone.xpm
                                                                        EA  textures/colorstone.xpm



C 12,1,123
F 2,155,2


     111111111111111111111111111111
111111111011000001110000000000001
100000000011000001110111   1111111
11110111111111011100000100011
11110111111111001101010010001
11000000110101011100000010001
10000000000000000000000000001
10000000000000001101010010001
1100000111010101111101111E00111
111111111111111111111111111111























