



NO                     textures/north_wall.xpm
                SO                                                 textures/mossy.xpm
WE                                                textures/greystone.xpm
                                                                        EA  textures/colorstone.xpm


C 12,1,123
F 2,155,2


      11111111111111111111111
1111110111111111011100000100011
1    101111111110001010100101
11000000110101011100000010001
10000000000000000000000000001
10000000000000001101010010001
1100000111010101111101111E001
11111111111111111111111111111
  






















