


NO textures/north_wall.xpm
SO textures/mossy.xpm
WE textures/greystone.xpm
EA textures/colorstone.xpm



C 12,1,123
F 2,155,2


111111111
10W101101
100000001
111111111
















