NO textures/north.xpm
SO textures/south.xpm
WE textures/west.xpm
EA textures/east.xpm
F 2,155,2
C 12,1,123
111111111
10W101101
100000001
111111111
